.....##....
.#...#.#.##
.##..##....
##..#.###..
#...#..#..#
#.#@.#....#
.##..#....#
..#..#...#
.#.#....##
.#.....##